XXXXXXX XXXXXXXXXXXXX XXXXXXX
X       X X   X   X X       X
X XXXXX X X X X X X X XXXXX X
X   X     X X X X X     X   X
X X XXXXX X X   X X XXXXX X X
X X   X   X X X X X   X   X X
X XXX XXXXX XXXXX XXXXX XXX X
X   X         X         X   X
XXXXXXX XXXXXXXXXXXXX XXXXXXX
