XXXXXXX XXXXXXX
X       X X   X
X XXXXX X X X X
X   X     X X X
X X XXXXX X X X
X X   X   X X X
X XXX XXXXX XXX
X   X         X
XXXXXXX XXXXXXX
