XXXXX XXX
X       X
X XXX XXX
X X X   X
X X XXXXX
X X X   X
X     X X
XXXXX XXX
